type octile
height 21
width 19
map
.....#.........#...
.#.###.#####.#.###.
.#.#...#.#...#.....
##.#.###.#.########
...#...#.#...#.....
.#####.#.###.#.###.
.......#...#...#.#.
.#######.#######.#.
.#.....#.........#.
.###.#.#######.###.
.....#.........#...
############.###.#.
.....#.....#.#...#.
.#####.###.#.#.####
...#...#.#.#.#.....
.#.#.###.#.#.#####.
.#.......#...#...#.
.###########.#.#.#.
.#.....#...#.#.#...
.#.###.#.#.###.###.
.#.#.....#.....#...
